#.#..&##..
...#..#...
##..#.#..#
.#........
...#@###..
..##.#....
#.#..##.&#
.#&..#...#
.....##..&
.##...#.##